

NO      textures/black_wall.png
SO      textures/black_wall.png
WE      textures/black_wall.png
EA      textures/
F 220,100,0

C 10,255,0

111111111111111111111111111111111111
100000000000000000000000000000000001
100000000010000000000000100000000001
100000000100000000000000100000000001
10000000100000000E000000100000000001
100000000100000000000000100000000001
100000000010000000000000100000000001
100000000000000000000000000000000001
111111111111111111111111111111111111