

NO      textures/black_wall.png
SO      textures/black_wall.png
WE      textures/black_wall.png
EA      textures/
F 220,100,0

C 10,255,0

        11111111111111111111111111
        10000000001100000000000001
        10110000011100000000000001
        10010000000000000000000001
1111111110110000011100000000000001
1000000000110000011101111111111111
11110111111111011100000010001
11110111111 111011101010010001
11000000110111011100000010001
10000000000000001100000010001
10000000000000001101010000001
11000001110101011111011110N0111
1111011111110101 101111010001
1111111101111111 111111111111
111111111111