

NO      textures/black_wall.png
SO      textures/black_wall.png
WE      textures/black_wall.png
EA      textures/
F 220,100,0

C 10,255,0

1111111111111111111   111111111  1111111
1000000010000000001   100000001  1000001
1000000010000000001111111001111111111101
1000000010000000000000001001111111111101
1000000010000000000000001001111111111101
1000000010000000000000001001111111111101
1000000010000000000000001001111111111101
1000000010000000000000001001111111111101
1000000010000000000000001001111111111101
10000000100000000000000E1001111111111101
1000000010000000000000001001111111111101
1111111111111111111111111111111111111111