NO     textures/no.xpm
SO     textures/so.xpm
WE     textures/we.xpm
EA     textures/ea.xpm

C  162,172,230
F  68,60,30

111111111111111111111111111111111111
100000000000000000000000000000000001
111100000001000000000000111111111111
10010001001111100000001111000000000011111111111111111111111111111111111111111
100000000111111D00N000D000000000000000000000000000000000000000000000000000001
10010000011111110000001111111111111111111111111111111111111111111111111111111
111100000001000000000000000000000001
100D00000000000000000000000000000001
111111111111111111111111111111111111