NO      textures/black_wall.png
SO      textures/black_wall.png
WE      textures/black_wall.png
EA      textures/

C  162,172,230
F  208,216,237

111111111111111111111111111111111111
100000000000000000000000000000000001
100000000010000000000000100000000001
100000000100000000000000100000000001
100000010000000000000000100000E00001
100000000100000000000000100000000001
100000000010000000000000100000000001
100000000000000000000000000000000001
111111111111111111111111111111111111