NO      textures/black_wall.png
SO      textures/black_wall.png
WE      textures/black_wall.png
EA      textures/

C 135,206,235
F 255,255,255

111111111111111111111111111111111111
100000000000000000000000000000000001
10E000000010000000000000100000000001
100000000100000000000000100000000001
100000010000000000000000100000000001
100000000100000000000000100000000001
100000000010000000000000100000000001
100000000000000000000000000000000001
111111111111111111111111111111111111