NO     textures/no.xpm
SO     textures/so.xpm
WE     textures/we.xpm
EA     textures/ea.xpm

C  162,172,230
F  68,60,30

11111111111111111111111111111111111111
10000000000000000000000000000000000111
1111000000010000000000000011111111111111111111111111111111111111111111111111
1000000001000010000001000000000000000000000000000000000000000000000000000001
10000001000000000N0000000000000000000000000000000000000000000000000000000001
1000000001000010000000100011111111111111111111111111111111111111111111111111
11110000000100000000000000000000000111
10000000000000000000000000000000000111
11111111111111111111111111111111111111