NO      textures/black_wall.png
SO      textures/black_wall.png
WE      textures/black_wall.png
EA      textures/

C  162,172,230
F  208,216,237

11111111111111111111111111111111111111111111111111
10000000000000000000000000000000000000000000000001
10001111001000000000000000000000000000000000000001
10000100001000000000000000000000000000000000000001
10000000001000000000000000000000000000000000000001
10000000001000011111110000000000000000000000000001
10000N00001000010010010000000000000000000000000001
10000000001000010101010000000000000000000000000001
10000000001000010000010000000000000000000000000001
10000000110000001101110000000000000000000000000001
1000000100000000100001000000000000000000000000001
1000000101000000010110000000000000000000000000001
10000000101011111000000000000000000000000000000001
10000000000000000000000000000000000000000000000001
11111111111111111111111111111111111111111111111111