NO      textures/m1/no.xpm
SO      textures/m1/so.xpm
WE      textures/m1/we.xpm
EA      textures/m1/ea.xpm

C  0,180,216
F  96,104,97

1    111111111111111111111111111
1    1000000D00001000010000D0001
1    100000010000D0000D000010001
1   1000011111111111111111111001
1  100011                   10001
1 11001                    110001
111001                   1110001
1100011111111111111111111000011111111111111111111
1000000000D00000000010000000000100000100001000001
100000000010000000001000000000010000010000D000001
1111111111011011111101000000000D00000100001000001
1000000000000010000010000000000100000101001000001
100001000E000011111110000000000100000100001000001
10000000000000100000D0000000000100100100001000001
1011111111111111000010000000000100000D00001000001
10000000000D0000000010000000000100000100010100001
1111111111111111111111111111111111111111111111111